arab: Arab ábécé

armenian: Az örmény ábécé

avestan: Az Avestan ábécé

balinese: A balinéz ábécé

bamum: Bamum ábécé

bashkir: Bashkir ábécé

bassa-vah: Bassa ábécé

batak: Batak ábécé

belarusian: Fehérorosz ábécé

bengali: Bengáli ábécé

bopomofo: Zhuyin ábécé. Bopomofo

brahmi: Brahmi ábécé

buginese: Buginai ábécé

buhid: Buhid ábécé

bulgarian: A bolgár ábécé

carian: A karian ábécé

caucasian-albanian: Kaukázusi albán ábécé

chakma: Chakma ábécé

cham: Chamsky ábécé

cherokee: Cherokee szlappikus ábécé

chinese: Kínai pinyin ábécé

coptic: Koptos ábécé

cypriot-syllabary: Ciprusi szlappikus ábécé

cyrillic: Cirill ábécé

czech: Cseh ábécé

deseret: Deseretian ábécé

devanagari: Devanagari ábécé

elbasan: Elbasan ábécé

english: Angol ábécé

esperanto: Eszperantó ábécé

ethiopic: Etiópiai szláv nyelvű ábécé

french: Francia ábécé

georgian: Grúz ábécé

german: Német ábécé

glagolitic: Glagolitikus ábécé

gothic: Gótikus ábécé

grantha: Grantha ábécé

greek: Görög ábécé

gujarati: Gujarati ábécé

gurmukhi: Gurmukhi ábécé

hangul: Koreai ábécé Hangeul

hanunoo: Hanunoo ábécé

hebrew: Héber ábécé

hungarian: Magyar ábécé

imperial-aramaic: Arámi császári ábécé

international-phonetic-alphabet: Nemzetközi fonetikus ábécé

italian: Olasz ábécé

japanese-hiragana: Japán Hiragana ábécé

japanese-katakana: Japán ábécé katakana

javanese: Jáva ábécé

kaithi: Kaithi ábécé

kannada: Kannada ábécé

kayah-li: Kayah ábécé

kazakh: Kazah betű

kharoshthi: Kharoshti ábécé

khmer: Khmer ábécé

khojki: Codic ábécé

khudawadi: Khudabadi ábécé

lao: Laoszi ábécé

latin: Latin ábécé

lepcha: A penész ábécéje

limbu: Alphabet Head

linear-b-Syllabary: Lineáris B betű

lisu: Betűs ábécé

lycian: Lyciás ábécé

lydian: Lidia ábécé

mahajani: Mahajani ábécé

malayalam: Malayalam ábécé

mandaic: Mandaean ábécé

manichaean: Manicheae ábécé

meetei-mayek: Matej-mahek ábécé

mende-kikakui: Kikakui ábécé Mende számára

meroitic-cursive: Meroitikus dőlt betű

modi: Modi ábécé

mongolian: Mongol régi ábécé

mro: Mro ábécé

myanmar: Burmai ábécé

nabataean: Nabateai ábécé

new-tai-lue: Tayla új ábécé

nko: Nko ábécé

ogham: Ogham ábécé

ol-chiki: Olchiki ábécé

old-italic: Etruszk ábécé

old-north-arabian: Arab északi régi ábécék

old-permic: Permian ősi ábécé

old-persian: Perzsa ókori cuneiform ábécé

old-south-arabian: Arabiai déli ábécé

old-turkic: Türkic ősrákos ábécé

oriya: Oriya ábécé

osmanya: Török ábécé

pahawh-hmong: Pachau ábécé

pahlavi: Pahlavi ábécé

palmyrene: Palmyra ábécé

pau-cin-hau: Pau Ching Hau ábécé

phags-pa: Pagba-lámai ábécé

phoenician: Föníciai ábécé

polish: Lengyel ábécé

pollard: Pollard ábécé

rejang: Rejan ábécé

runic: Germán rózsás ábécé

russian: Orosz betű

samaritan: Szamaritánus ábécé

saurashtra: Saurastra ábécé

sharada: Charade ábécé

shavian: Bernard Show ábécé

siddham: Siddhamataka ábécé

sinhala: Szingaléz ábécé

sora-sompeng: Sorang Sompeng ábécé

spanish: Spanyol ábécé

sundanese: Szundán ábécé

syloti-nagri: Sylheti nagari ábécé

syriac: Szíriai ábécé

tagalog: Tagalog abc

tagbanwa: Tagbanwa ábécé

tai-le: Tai Lai ábécé

tai-tham: Tai tham ábécé

tai-viet: Tai megnyeri az ábécét

takri: Takri ábécé

tamil: Tamil ábécé

tatar: Tatár ábécé

telugu: Telugu ábécé

thaana: Tana ábécé

thai: Thai ábécé

tibetan: Tibeti ábécé

tifinagh: Typhanag ábécé

tirhuta: Tyrhuta ábécé

turkish: Török ábécé

ugaritic: Ugaritikus ábécé

ukrainian: Ukrán ábécé

unified-canadian-aboriginal-syllabics: Kanadai aboriginális szlappikus ábécé

vai: Vai szótagos ábécé

varang-kshiti: Varang kshiti ábécé

yi-syllables: És a szllabi ábéc nyelvét
