control-character : Vezérlőkarakterek
basic-latin     : Latin (alap)
latin-1-supplement : Latin-1 kiegészítő karakterek
latin-extended-a : Bővített Latin (A)
latin-extended-b : Bővített Latin (B)
ipa-extensions  : IPA kiterjesztések
spacing-modifier-letters : Fonetikus jelek
combining-diacritical-marks : Kombinált diakritikus jelek
greek-coptic    : Görög és Kopt
cyrillic        : Cirill
cyrillic-supplement : Cirill kiegészítő karakterek
armenian        : Örmény
hebrew          : Héber
arabic          : Arab
syrian          : Szír
arabic-supplement : Arab kiegészítő karakterek
thaana          : Thaana
nko             : Nko
samaritan       : Szamaritán
mandaic         : Mandaic
arabic-extended-a : Kiterjesztett Arab (A)
devanagari      : Dévanágari
bengali         : Bengáli
gurmukhi        : Gurmukhi
gujarati        : Gudzsarati
oriya           : Orija
tamil           : Tamil
telugu          : Telugu
kannada         : Kannada
malayalam       : Malayalam
sinhala         : Sinhala
thai            : Thai
lao             : Lao
tibetan         : Tibeti
myanmar         : Burmai
georgian        : Grúz
hangul-jamo     : Hangul Jamo
ethiopic        : Etióp
ethiopic-supplement : Etióp kiegészítő karakterek
cherokee        : Cseroki
unified-canadian-aboriginal-syllabics : Egyszerűsített kanadai bennszülött jelek
ogham           : Ogham
runic           : Runic
tagalog         : Tagalog
hanunoo         : Hanunóo
buhid           : Buhid
tagbanwa        : Tagbanwa
khmer           : Khmer
mongolian       : Mongol
unified-canadian-aboriginal-syllabics-extended : Egyszerűsített kanadai bennszülött jelek kiegészítése
limbu           : Limbu
tai-le          : Tai Le
new-tai-lue     : Új Tai Lü
khmer-symbols   : Khmer szimbólumok
buginese        : Buginéz
tai-tham        : Tai Tham
balinese        : Balinéz
sundanese       : Szudán
batak           : Batak
lepcha          : Lepcha
ol-chiki        : Ol Chiki
sundanese-supplement : Bővített Szudán
vedic-extensions : Kiegészített Vedik
phonetic-extensions : Fonetikus kiegészítések
phonetic-extensions-supplement : Fonetikus bővítések kiegészítései
combining-diacritical-marks-supplement : Kombinált diakritikus jelek kiegészítése
latin-extended-additional : Latin bővítések kiegészítései
greek-extended  : Bővített Görög
general-punctuation : Általános elválasztó jelek
superscripts-and-subscripts : Alsó- és felsőindexek
currency-symbols : Pénzjelek
combining-diacritical-marks-for-symbols : Kombinált diakritikus jelek szimbólumokhoz
letterlike-symbols : Betűszerű szimbólumok
number-forms    : Szám formátumok
arrows          : Nyilak
mathematical-operators : Matematikai műveleti jelek
miscellaneous-technical : Vegyes technikai jelek
control-pictures : Irányító képek
optical-character-recognition : OCR karakterek
enclosed-alphanumerics : Enclosed Alphanumerics
box-drawing     : Rajzdobozok
block-elements  : Blokk szimbólumok
geometric-shapes : Geometrikus alakzatok
miscellaneous-symbols : Vegyes szimbólumok
dingbats        : Dingbats
miscellaneous-mathematical-symbols-a : Vegyes matematikai szimbólumok (A)
suplemental-arrows-a : Nyilak kiegészítés (A)
braille-patterns : Braille jelek
suplemental-arrows-b : Nyilak kiegészítés (B)
miscellaneous-mathematical-symbols-b : Vegyes matematikai szimbólumok (B)
supplemental-mathematical-operators : Kiegészítő matematikai műveleti jelek
miscellaneous-symbols-and-arrows : Vegyes szimbólumok és nyilak
glagolitic      : Glagolita
latin-extended-c : Kiegészített Latin (C)
coptic          : Kopt
georgian-supplement : Grúz kiegészítések
tifinagh        : Tifinagh
ethiopic-extended : Bővített Etióp
cyrillic-extended : Kiegészített Cirill (A)
supplemental-punctuation : Elválasztó jelek kiegészítései
cjk-radicals-supplement : CJK gyökök kiegészítés
kangxi-radicals : Kangxi gyökök
ideographic-description-characters : Ideografikus leíró karakterek
cjk-symbols-and-punctuation : CJK szimbólumok és elválasztók
hiragana        : Hiragana
katakana        : Katakana
bopomofo        : Bopomofo
hangul-compatibility-jamo : Hangul Compatibility Jamo
kanbun          : Kanbun
bopomofo-extended : Bővített Bopomofo
cjk-strokes     : CJK ecsetvonások
katakana-phonetic-extensions : Katakana fonetikus bővítések
enclosed-cjk-letters-and-months : Enclosed CJK Letters and Months
cjk-compatibility : CJK-kompatibilis
cjk-unified-ideographs-extension-a : CJK egyszerűsített szókép bővítés (A)
yijing-hexagram-symbols : Yijing hexagram szimbólumok
cjk-unified-ideographs : CJK egyszerűsített szóképek
yi-syllables    : Ji jelek
yi-radicals     : Ji gyökök
old-lisu-alphabet : Vai
ciryllic-extended-B : Kiegészített Cirill (B)
bamum           : Bamum
modifier-tone-letters : Hangmódosító betűk
latin-extended-d : Kiegészített Latin (D)
syloty-nagri    : Syloti Nagri
indian-numeric-character : Indiai számkarakterek
phags-pa        : Phags-pa
saurashtra      : Saurashtra
devanagari-extended-characters : Kiegészített Devanagari
kayah-li        : Kayah Li
rejang          : Rejang
hangul          : Kiegészített Hangul Jamo (A)
javanese-alphabet : Javanese
cham-alphabet   : Cham
burmese-alphabet-extention-a : Kiegészített Mynmar (A)
tai-viet-alphabet : Tai Viet
meitei-language-extensions : Meetei Mayek kiegészítései
ethiopic-extended-a : Kiegészített Etióp (A)
meitei-language : Meetei Mayek
hangul-syllables : Hangul jelek
high-surrogates : Magas pótlók
high-private-use-surrogates : Magas privát használatú pótlók
low-surrogates  : Alacsony pótlók
private-use-area : Saját célra fenntartott
cjk-compatibility-ideographs : CJK kompatibilis szóképek
alphabetic-presentation-forms : Alfabetikus megjelenítési formák
arabic-presentation-forms-a : Arab prezentációs formák (A)
variation-selectors : Kijelölés változatok
vertical-forms  : Függőleges formák
combining-half-marks : Kombinált fél-jelzők
cjk-compatibility-forms : CJK-kompatibilis formák
small-form-variants : Kisebb forma változatok
arabic-presentation-forms-b : Arab prezentációs formák (B)
halfwidth-and-fullwidth-forms : Félszélességű és teljes szélességű formák
specials        : Speciális jelek
linear-b-syllabary : Lineáris B-írás jelei
linear-b-ideograms : Lineáris B-írás ideogramjai
aegean-numbers : Égei számok
ancient-greek-numbers : Ősi görög számok
ancient-symbols : Ősi szimbólumok
phaistos-disc : Phaistos Disc
lycian : Lycian
carian : Carian
coptic-epact-numbers : Kopt számok
old-italic : Régi Olasz
gothic : Gótikus
old-permic : Régi Perm-i
ugaritic : Ugar
old-persian : Régi Perzsai
deseret : Deseret
shavian : Shavian
osmanya : Osmanya
elbasan : Elbasan
caucasian-albanian : Kaukázusi Albán
linear-a : Lineáris A
cypriot-syllabary : Ciprusi jelek
imperial-aramaic : Imperial Aramaic
palmyrene : Palmyrene
nabataean : Nabataean
phoenician : Főníciai
lydian : Lydian
meroitic-hieroglyphs : Meroitic Hieroglifák
meroitic-cursive : Meroitic Kurzív
kharoshthi : Kharoshthi
old-south-arabian : Régi Dél-Arab
old-north-arabian : Régi Észak-Arabian
manichaean : Manichaean
avestan : Avestan
inscriptional-parthian : Inscriptional Parthian
inscriptional-pahlavi : Inscriptional Pahlavi
psalter-pahlavi : Psalter Pahlavi
old-turkic : Régi Török
rumi-numeral-symbols : Rumi Numeral Symbols
brahmi : Brahmi
kaithi : Kaithi
sora-sompeng : Sora Sompeng
chakma : Chakma
mahajani : Mahajani
sharada : Sharada
sinhala-archaic-numbers : Sinhala Arhaikus számok
khojki : Khojki
khudawadi : Khudawadi
grantha : Grantha
tirhuta : Tirhuta
siddham : Siddham
modi : Modi
takri : Takri
warang-citi : Warang Citi
pau-cin-hau : Pau Cin Hau
cuneiform : Cuneiform
cuneiform-numbers-and-punctuation : Cuneiform számok és írásjelek
egyptian-hieroglyphs : Egyiptomi Hieroglifák
bamum-supplement : Kiegészített Bamum
mro : Mro
bassa-vah : Bassa Vah
pahawh-hmong : Pahawh Hmong
miao : Miao
kana-supplement : Kiegészített Kana
duployan : Duployan
shorthand-format-controls : Shorthand Formátumirányítás
byzantine-musical-symbols : Byzantine zenei szimbólumok
musical-symbols : Zenei szimbólumok
ancient-greek-musical-notation : Ógörög zenei szimbólumok
tai-xuan-jing-symbols : Tai Xuan Jing szimbólumok
counting-rod-numerals : Számolórúd számai
mathematical-alphanumeric-symbols : Matematikai alfanumerikus szimbólumok
mende-kikakui : Mende Kikakui
arabic-mathematical-alphabetic-symbols : Arab matematekai alfabetikus szimbólumok
mahjong-tiles : Mahjong-kövek
domino-tiles : Dominókövek
playing-cards : Játékkártyák
enclosed-alphanumeric-supplement : Zárt alfanumerikus kiegészítés
enclosed-ideographic-supplement : Zárt ideografikus kiegészítés
miscellaneous-symbols-and-pictographs : Egyéb szimbólumok és piktogramok
emoticons : Hangulatjelek (Emoji)
ornamental-dingbats : Ornamental Dingbats
transport-and-map-symbols : Közlekedés- és térképszimbólumok
alchemical-symbols : Alkímiai szimbólumok
geometric-shapes-extended : Kiegészített geometriai alakzatok
supplemental-arrows-c : Kiegészített nyilagk (C)
combining-diacritical-marks-extended: Kombinált, kiegészített diakritikus jelek
lisu: Lisu
myanmar-extended-b: Kiegészített Myanmar (B)
latin-extended-e: Kiegészített Latin (E)
hangul-jamo-extended-b: Kiegészített Hangul Jamo (B)
