title           : Unicode karaktertábla
search          : Karakter keresése
find            : Keress
example         : Példa
example_text    : kalapács és kasza;nyíl;szív;csillag;háromszög;pipa;karika;kereszt;négyzet;golyó
about           : Rólunk
not_language    : Hol van a nyelvem?
popular         : Leghíresebb karakterek
loading         : Töltés...
unicode_number  : Unicode-szám
html_code       : <span class="caps">HTML</span>-kód
uppercase       : Nagybetűs
lowercase       : Kisbetűs
encoding        : Kódolás
block           : Blokk
set             : Beállítás
up              : Fel
range           : Tartomány
type            : Típus
countries       : Országok
count           : Karakterek száma
languages       : Nyelvek
sort_order      : Rend szerint
sort_block      : Blokkonként
copy_clipboard  : Másolás a vágólapra
search_h1       : Keresés
search_result   : Eredmény
search_empty    : A keresőmező üres
search_total    : Teljes: %s
search_limit    : (csak %s -et mutat)
search_none     : Semmi
search_any      : Keresés bármely szóból
help_range      : Nyomj ide, hogy a tartomány kiemelődjön
blocks_list     : Unicode blokkok
languages_list  : Nyelv
languages_blocks : Nyelvblokk
types_list      : Típusok
countries_list  : Országok
more            : Több
sets            : Karakterkészlet
ny_symbols      : Karácsonyi és NY-szimbólumok
prev            : Előző
next            : Következő
entity          : Egység
search_overflow : Elnézést, a U+%s-s szimbólum fejlesztés alatt áll :)
feedback        : Visszajelzés
separate_page   : Megnyitás egy külön lapon
edit            : Szerkesztés
save            : Mentés
submit          : Elküldés
undo            : Visszavonás
send_changes    : A változtatások a fejlesztőknek lesznek elküldve. Biztos vagy benne?
edit_thanks     : Köszönjük!
gotofullversion : Ugrás a teljes verzióra
sharelink       : Megosztom
readmore        : Olvass tovább
readless        : Elrejt
yourbrowser     : A böngésző
fontview        : Felirat a karakter különböző betűtípusokat
chardesc        : karakter leírása

# __________________________________________________________
#
# FOOTER / МЕНЮ ПОДВАЛА
# __________________________________________________________

feedback        : Visszajelzés
github          : GitHub
twitter         : Twitter
join_us         : Szeretnék csatlakozni!
donate          : Hogyan tudok adományozni?
unicode         : Unicode
about_unicode   : Az Unicode-ról
unicode_history : Az Unicode történelme
unicode_versions: Az Unicode verziói
broken_chars    : Néhány karaktert nem mutat
cyrillic        : Cirill
fonts           : Betűtípusok



# __________________________________________________________
#
# TOOLS / ИНСТРУМЕНТЫ   http://unicode-table.com/tools/
# __________________________________________________________

tools           : Eszközök
encoder         : Kódoló
encoder-desc    : Karaktereket kódol HTML-kódra és vissza
encoder-plain   : Normál szöveg
encoder-full    : Teljes
encoder-text    : Szöveg
encoder-entities: Karakterkódolás egységekkel
encoder-br      : Sortörések kódolása

decoder         : Dekódoló
decoder-desc    : Karaktereket kódól Unicode-ra és vissza
decoder-example : Ez egy példa
decoder-code    : Unicode
decoder-text    : Szöveg

flip            : Megfordító
flip-desc       : Megfordítja a Cirill és Latin betűket és vissza
flip-plain      : Normál szöveg
flip-flipped    : Fordított szöveg
flip-backed     : Vissza az első szövegre

toolsgenerator : Unicode-karaktertábla generátor
toolsgenerator-desc : Karaktereket generál egy megadott intervallumban
toolsgenerator-range: Intervallum
toolsgenerator-format: Formátum
toolsgenerator-info: Elérhető: {symbol}, {dec}, {hex}, {html}
toolsgenerator-text-generate: Generálás
toolsgenerator-result: Eredmény

# CONTENT

content-sorry: Elnézést, ennek a karakternek a részletein még dolgozunk.
content-sorry-lang: Elnézést, több információ nem érhető el magyarul. Próbálunk ezen javítani.
content-other: Ez a szöveg már nyelveken elérhető:
content-sorry-other: További nyelvek:

# SEO

meta_description : Az összes Unicode karakter nevekkel és leírásokkal egy helyen: ❤ ☀ ★ ☂ ☻ ♞ ☯ ☭ ☢ € → ☎ ❄ ♫ ✂ ▶ ✇ ♎ ⇧ ☮ ♻ ⌘ ⌛ ☘ ✈ ✔ ☊ ♔ ♕ ♖ ☦ ✝ ❖ ➎ ♠ ♣ ♥ ♦ ♂ ♀ ❂ ❃ ✒
meta_keywords   : unicode, jelek, szimbólumok, karakterek, unicode tábla, karakterkészlet, unicód karakterek listája, utf-8, facebook karakterek, kódolás, szív jel, szkript, nyelvek, emoji, hieroglyphs, rúnák, nyíl szimbólumok, cirill, latin, pénznem szimbólumok
symbol_description: Szimbólum: {{symbol}}, Név: {{name}}, Unicode szám: {{code}}, Blokk: {{block}}{% if entity %}, Egység: {{ entity }}{% endif %}
symbol_title: szimbólum, karakter, jel, ikon
