title           : Unicode字符百科
search          : 搜索字符
find            : 寻找
example         : 例子
example_text    : hammer and sickle
about           : 关于
not_language    : 我的语言呢？
popular         : 最热门字符
loading         : 正在载入，请稍等
unicode_number  : Unicode编号
html_code       : <span class="caps">HTML</span>代码
uppercase       : 大写
lowercase       : 小写
up              : 回顶部
range           : 范围
type            : 类型
countries       : 国家地区
count           : 字符总数
languages       : 语言
sort_order      : 按顺序
sort_block      : 按字符范围分段
copy_clipboard  : 复制到剪贴板
search_h1       : 搜索
search_result   : 搜索结果
search_empty    : 搜索关键词是空的
search_total    : 总共结果：%s
search_limit    : （只显示了 %s）
search_none     : 无
search_any      : 用任何关键词搜索
help_range      : 点击显示字符范围
blocks_list   : Unicode 字符段列表
languages_list  : 语言列表
languages_blocks : 该语言使用的字符范围
types_list      : 字符类型列表
countries_list  : 国家地区列表
more            : 更多
sets            : 符号分类集汇
ny_symbols      : 圣诞与新年符号
prev            : 向前
next            : 向后
entity          : 实体
search_overflow : 对不起，U+%s 数据库还在制作中
feedback        : 反馈信息
separate_page   : 新开页面
edit            : 编辑
save            : 保存
submit          : 提交
undo            : 撤消
send_changes    : 您所做的更改将被发送到该网站的开发。你确定吗？
edit_thanks     : 谢谢
gotofullversion : 查看完整版
sharelink       : 分享
readmore        : 阅读更多
readless        : 隐藏
yourbrowser     : 您的浏览器
fontview        : 性格不同字体的题字
chardesc        : 人物介绍
# __________________________________________________________
#
# FOOTER / МЕНЮ ПОДВАЛА
# __________________________________________________________

feedback        : 反馈信息
github          : GitHub
twitter         : Twitter
join_us         : 我想参与
donate          : 如何捐助
unicode         : Unicode（万国码）
about_unicode   : 关于 Unicode
unicode_history : Unicode 历史
unicode_versions: Unicode 版本
broken_chars    : 有些字符显示不正确？
cyrillic        : 西里尔文
fonts           : 字体



# __________________________________________________________
#
# TOOLS / ИНСТРУМЕНТЫ   http://unicode-table.com/tools/
# __________________________________________________________

tools           : 工具
encoder         : 编码器
encoder-desc    : 将字符与HTML代码相互转换
encoder-plain   : 字符
encoder-full    : 全部转换
encoder-text    : 文本
encoder-entities: 按HTML实体编码
encoder-br      : 编码换行

decoder         : 解码器
decoder-desc    : 将字符编码为Unicode转义文本或者反之
decoder-example : 这是栗子
decoder-code    : Unicode转义文本
decoder-text    : 文本

flip            : 翻转
flip-desc       : 将英语字母或者西里尔语“倒”过来
flip-plain      : 文本
flip-flipped    : 倒过来！
flip-backed     : 只调换顺序

toolsgenerator : Unicode字符表生成
toolsgenerator-desc : 产生一组字符的指定范围内
toolsgenerator-range: 范围
toolsgenerator-format: 格式
toolsgenerator-info: 可用： {symbol}, {dec}, {hex}, {html}
toolsgenerator-text-generate: 生成
toolsgenerator-result: 结果

# CONTENT

content-sorry: 对不起，目前没有进一步的消息。
content-sorry-lang: 抱歉，在英国进一步的信息不可用。我们正努力使它很快面市。
content-other: 文本还可以在以下语言：
content-sorry-other: 查看其它语言版本：

# SEO

meta_description : 各种Unicode字符的名字与描述：❤ ☀ ★ ☂ ☻ ♞ ☯ ☭ ☢ € → ☎ ❄ ♫ ✂ ▶ ✇ ♎ ⇧ ☮ ♻ ⌘ ⌛ ☘ ✈ ✔ ☊ ♔ ♕ ♖ ☦ ✝ ❖ ➎ ♠ ♣ ♥ ♦ ♂ ♀ ❂ ❃ ✒
meta_keywords   : unicode, signs, symbols, characters, unicode table, character set, list of unicode characters, utf-8, facebook characters, encoding, heart symbol, script, languages, emoji, hieroglyphs, runes, arrow symbols, cyrillic, latin, currency symbols
symbol_description: 符号: {{symbol}}, 名称: {{name}}, Unicode的数量: {{code}}, 座: {{block}}{% if entity %}, 实体: {{ entity }}{% endif %}
symbol_title: 符号，文字，符号，图标
