arab : 아랍어 알파벳

armenian : 아르메니아 알파벳

avestan : 아베스탄 알파벳

balinese : 발리의 알파벳

bamum : 바움 알파벳

bashkir : 바시 키르 알파벳

bassa-vah : 밧 바 알파벳

batak : 바 정력 알파벳

belarusian : 벨로루시 어 알파벳

bengali : 벵골어 알파벳

bopomofo : 주음 자모 (주음 부호)

brahmi : 브라 미미 알파벳

buginese : 부기 알파벳

buhid : 부 히드 문자

bulgarian : 불가리아 알파벳

carian : 카리안 알파벳

caucasian-albanian : 코카서스 알바니아 알파벳

chakma : 차 곰 알파벳

cham : 참 알파벳

cherokee : 체로키 알파벳

chinese : 중국어 병음 알파벳

coptic : 코프 틱 알파벳

cypriot-syllabary : 키프로스 음절

cyrillic : 키릴 문자

czech : 체코 어 알파벳

deseret : Deseret 알파벳

devanagari : 드 파나 갈리 알파벳

elbasan : 엘바 산의 알파벳

english : 영어 알파벳

esperanto : 에스페란토 문자

ethiopic : 에티오피아 Ge'ez 알파벳

french : 프랑스어 알파벳

georgian : 조지아의 알파벳

german : 독일어 알파벳

glagolitic : 그라 가릿토 알파벳

gothic : 고딕 알파벳

grantha : 그란 지원 알파벳

greek : 그리스어 알파벳

gujarati : 구자라트 어 알파벳

gurmukhi : 그룸 키 알파벳

hangul : 한글 알파벳

hanunoo : 하누 누 알파벳

hebrew : 히브리 문자

hungarian : 헝가리어 알파벳

imperial-aramaic : 황제 아람어 알파벳

international-phonetic-alphabet : 국제 발음 기호

italian : 이탈리아어 알파벳

japanese-hiragana : 일본어 히라가나 알파벳

japanese-katakana : 일본어 카타카나 알파벳

javanese : 자바 알파벳

kaithi : 카이 티 알파벳

kannada : 칸나 다 알파벳

kayah-li : 카야 리 문자

kazakh : 카자흐어 알파벳

kharoshthi : 카로 시티 알파벳

khmer : 크메르 알파벳

khojki : 거지 알파벳

khudawadi : 쿠다 와디 알파벳

lao : 라오 어 알파벳

latin : 라틴 알파벳

lepcha : Lepcha 알파벳

limbu : 림 흔들림 알파벳

linear-b-Syllabary : 리니어 B 음절

lisu : Lisu 알파벳

lycian : 리 시안 알파벳

lydian : 리디아 바겐 알파벳

nabataean : 나 바타리안 알파벳

mahajani : 마하 자니 알파벳

malayalam : 말라 얄 알파벳

mandaic : 만다 알파벳

manichaean : 마니카이아 알파벳

meetei-mayek : 마니뿌리 문자 알파벳

mende-kikakui : 남자 데키 여러분 알파벳

meroitic-cursive : 메로에이토 필기체 알파벳

modi : 모디 알파벳

mongolian : 몽골 알파벳

mro : 모로코 알파벳

myanmar : 미얀마 알파벳

new-tai-lue : 새로운 타이 알파벳

nko : 징코 알파벳

ogham : 나 껌 알파벳

ol-chiki : 올 치키 알파벳

old-italic : 오래된 기울임 에트루리아 알파벳

old-north-arabian : 구 북부 알파벳

old-permic : 오래된 permic 알파벳

old-persian : 구 페르시아어 알파벳

old-south-arabian : 오래된 남쪽 아라비아 인의 알파벳

old-turkic : 고대 터키어 알파벳

oriya : 오 리어 알파벳

osmanya : 오스만 야 알파벳

pahawh-hmong : 빠하우아 알파벳

pahlavi : 팔레 루비 알파벳

palmyrene : 팔미 진 알파벳

pau-cin-hau : 포 싱 뉴 알파벳

phags-pa : Phags-pa 알파벳

phoenician : 훼니시아 알파벳

polish : 폴란드 알파벳

pollard : 폴란드 알파벳

rejang : 레 장 알파벳

runic : 르 닉 알파벳

russian : 러시아 문자

samaritan : 사마리아의 알파벳

saurashtra : 사라 슈트라 알파벳

sharada : 샤라 다 알파벳

shavian : 샤 비안 알파벳

siddham : 시드 햄 알파벳

sinhala : 싱 할라 알파벳

sora-sompeng : 소라 · 문뻰구 알파벳

spanish : 스페인어 알파벳

sundanese : 다어 알파벳

syloti-nagri : 시로티 · 구타 문자 알파벳

syriac : 시리아 알파벳

tagalog : 타갈로그어 알파벳

tagbanwa : 타구바누아 알파벳

tai-le : 태국 알파벳

tai-tham : 북의 알파벳

tai-viet : 타이 베이트 알파벳

takri : 타쿠리 알파벳

tamil : 타밀어 알파벳

tatar : 타타르 알파벳

telugu : 텔루구 어 알파벳

thaana : 데이터 함정 알파벳

thai : 타이 알파벳

tibetan : 티베트의 알파벳

tifinagh : 티후나구 문자 알파벳

tirhuta : 티르 알파벳

turkish : 터키어 알파벳

ugaritic : 우가니아 알파벳

ukrainian : 우크라이나어 알파벳

unified-canadian-aboriginal-syllabics : 통일 된 캐나다 출신의 음절

vai : 가나다

varang-kshiti : 바 순위 시티 알파벳

yi-syllables : 이 문자 (이 문자) 
