abkhazia    : 압하 지아
afghanistan : 아프가니스탄
algeria     : 알제리
armenia     : 아르메니아
australia   : 호주
azerbaijan  : 아제르바이잔
bahrain     : 바레인
bali        : 발리
bangladesh  : 벵골
bosnia      : 보스니아
bulgaria    : 불가리아 사람
burma       : 미얀마
#bhutan?	
butane      : 부탄
cambodia    : 캄보디아
cameroon    : 카메룬
canada      : 캐나다
china       : 중국
croatia     : 크로아티아
egypt       : 이집트
england     : 영어
eritrea     : 에리트레아
estland     : Estland
ethiopia    : 에티오피아
fiji_islands : 피지 제도
finland     : 핀란드
france      : 프랑스
georgia     : 그루지야
germany     : 독일
goa         : 고아
greece      : 그리스
guam        : 괌
guinea      : 기니
herzegovina : 헤르 체코 비나
hungary     : 헝가리
india       : 인도
indonesia   : 인도네시아
iran        : 이란
iraq        : 이라크
ireland     : 아일랜드
israel      : 이스라엘
italy       : 이탈리아
jakarta     : 자카르타
japan       : 일본
kashmir     : 카슈미르
kazakhstan  : 카자흐스탄
kenya       : 케냐
kuwait      : 쿠웨이트
laos        : 라오스
levant      : 레반트
liberia     : 라이베리아
libya       : 리비아
lombok      : 롬복
macedonia   : 마케도니아
malaysia    : 말레이시아
maldives    : 몰디브
mali        : 말리
malta       : 몰타
mauritius   : 모리셔스
mesopotamia : 메소포타미아
moldova     : 몰르 더바
mongolia    : 몽골리아
montenegro  : 몬테네그로
myanmar     : 미얀마
nepal       : 네팔
nigeria     : 나이지리아
north_africa : 북아프리카
north_korea : 북한
north_philippines : 북부 필리핀
norway      : 노르웨이
pakistan    : 파키스탄
peru        : 페루
philippines : 필리핀
poland      : 폴란드
rumania     : 루마니아
russia      : 러시아
salvador    : 엘살바도르
scotland    : 스코틀랜드
serbia      : 세르비아
sierra_leone : 시에라 리온 시에라 리온
singapore   : 싱가포르
slovenia    : 슬로베니아
somalia     : 소말리아
south_korea : 한국
sri_lanka   : 스리랑카
sudan       : 수단
sumatra     : 수마트라
sweden      : 스웨덴
syria       : 시리아
taiwan      : 대만
tanzania    : 탄자니아
thailand    : 태국
tibet       : 티베트
turkey      : 터키
uganda      : 우간다
ukraine     : 우크라이나
usa         : 미국
vietnam     : 베트남
wales       : 웨일스 말 

