abkhazia : アブハジア
afghanistan : アフガニスタン
algeria  : アルジェリア
armenia  : アルメニア
australia   : オーストラリア
azerbaijan  : アゼルバイジャン
bahrain  : バーレーン
bali     : バリ
bangladesh  : ベンガル
bosnia   : ボスニア
bulgaria : ブルガリア語
burma    : ミャンマー
#bhutan?	
butane   : ブータン
cambodia : カンボジア
cameroon : カメルーン
canada   : カナダ
china    : 中国
croatia  : クロアチア
egypt    : エジプト
england  : 英語
eritrea  : エリトリア
estland  : Estland
ethiopia : エチオピア
fiji_islands : フィジー諸島
finland  : フィンランド
france   : フランス
georgia  : ジョージア
germany  : ドイツ
goa      : ゴア
greece   : ギリシャ
guam     : グアム
guinea   : ギニア
herzegovina : ヘルツェゴビナ
hungary  : ハンガリー
india    : インド
indonesia   : インドネシア
iran     : イラン
iraq     : イラク
ireland  : アイルランド
israel   : イスラエル
italy    : イタリア
jakarta  : ジャカルタ
japan    : 日本
kashmir  : カシミール
kazakhstan  : カザフスタン
kenya    : ケニア
kuwait   : クウェート
laos     : ラオス
levant   : レバント
liberia  : リベリア
libya    : リビア
lombok   : ロンボク島
macedonia   : マケドニア
malaysia : マレーシア
maldives : モルディブ
mali     : マリ
malta    : マルタ
mauritius   : モーリシャス
mesopotamia : メソポタミア
moldova  : モルドバ
mongolia : モンゴル
montenegro  : モンテネグロ
myanmar  : ミャンマー
nepal    : ネパール
nigeria  : ナイジェリア
north_africa : 北アフリカ
north_korea : 北朝鮮
north_philippines : フィリピン北部
norway   : ノルウェー
pakistan : パキスタン
peru     : ペルー
philippines : フィリピン
poland   : ポーランド
rumania  : ルーマニア
russia   : ロシア
salvador : エルサルバドル
scotland : スコットランド
serbia   : セルビア
sierra_leone : シエラレオネシエラレオネ
singapore   : シンガポール
slovenia : スロベニア
somalia  : ソマリア
south_korea : 韓国
sri_lanka   : スリランカ
sudan    : スーダン
sumatra  : スマトラ
sweden   : スウェーデン
syria    : シリア
taiwan   : 台湾
tanzania : タンザニア
thailand : タイ
tibet    : チベット
turkey   : トルコ
uganda   : ウガンダ
ukraine  : ウクライナ
usa      : アメリカ
vietnam  : ベトナム
wales    : ウェールズ語 

