# __________________________________________________________
#
# Language File: Thai (ภาษาไทย) - TH by Thanapon Namjittrong
# __________________________________________________________

control-character : อักขระควบคุม
basic-latin     : อักษรละตินพื้นฐาน
latin-1-supplement : อักษรละติน-1 เพิ่มเติม
latin-extended-a : อักษรละตินส่วนเพิ่ม-A
latin-extended-b : อักษรละตินส่วนเพิ่ม-B
ipa-extensions  : ส่วนขยาย IPA
spacing-modifier-letters : อักษรปรับเปลี่ยนระยะห่าง
combining-diacritical-marks : เครื่องหมายกำกับเสียงแบบรวม
greek-coptic    : อักษรกรีกและคอปติก
cyrillic        : อักษรซีริลลิก
cyrillic-supplement : อักษรซีริลลิกเพิ่มเติม
armenian        : อักษรอาร์เมเนีย
hebrew          : อักษรฮีบรู
arabic          : อักษรอาหรับ
syrian          : อักษรซีเรียค
arabic-supplement : อักษรอาหรับเพิ่มเติม
thaana          : อักษรทานะ
nko             : อักษรอึนโก
samaritan       : อักษรซามาเรีย
mandaic         : อักษรแมนเดอิก
arabic-extended-a : อักษรอาหรับส่วนเพิ่ม-A
devanagari      : อักษรเทวนาครี 
bengali         : อักษรเบงกาลี
gurmukhi        : อักษรคุรมุขี
gujarati        : อักษรคุชราต 
oriya           : อักษรโอริยา 
tamil           : อักษรทมิฬ 
telugu          : อักษรเตลูกู 
kannada         : อักษรกันนาดา
malayalam       : อักษรมาลายาลัม 
sinhala         : อักษรสิงหล
thai            : อักษรไทย
lao             : อักษรลาว
tibetan         : อักษรทิเบต
myanmar         : อักษรพม่า
georgian        : อักษรจอร์เจีย
hangul-jamo     : อักษรจาโมของฮันกึล
ethiopic        : อักษรเอธิโอเปีย 
ethiopic-supplement : อักษรเอธิโอเปียเพิ่มเติม
cherokee        : อักษรเชอโรกี 
unified-canadian-aboriginal-syllabics : พยัญชนะพื้นเมืองแคนาดา
ogham           : อักษรโอคัม
runic           : อักษรรูนิก
tagalog         : ภาษาตากาล็อก
hanunoo         : อักษรฮานูโนโอ
buhid           : อักษรบูฮิด
tagbanwa        : อักษรตักบันวา
khmer           : อักษรเขมร 
mongolian       : อักษรมองโกเลีย
unified-canadian-aboriginal-syllabics-extended : พยัญชนะพื้นเมืองแคนาดาส่วนเพิ่ม
limbu           : อักษรลิมบู
tai-le          : อักษรไทลื้อ
new-tai-lue     : อักษรไทลื้อใหม่
khmer-symbols   : สัญลักษณ์ภาษาเขมร
buginese        : ภาษาบูกิส
tai-tham        : อักษรธรรมล้านนา
balinese        : อักษรบาหลี 
sundanese       : ภาษาซุนดา
batak           : อักษรบาตัก 
lepcha          : อักษรเลปชา 
ol-chiki        : อักษรโอลชิคิ 
sundanese-supplement : ภาษาซุนดาเพิ่มเติม
vedic-extensions : ส่วนขยายทางเวท
phonetic-extensions : ส่วนขยายทางสัทศาสตร์ 
phonetic-extensions-supplement : ส่วนขยายทางสัทศาสตร์เพิ่มเติม
combining-diacritical-marks-supplement : เครื่องหมายกำกับเสียงแบบรวมเพิ่มเติม
latin-extended-additional : อักษรละตินส่วนเพิ่มเติม 
greek-extended  : อักษรกรีกส่วนเพิ่ม 
general-punctuation : เครื่องหมายวรรคตอนทั่วไป
superscripts-and-subscripts : ตัวยกและตัวห้อย
currency-symbols : สัญลักษณ์สกุลเงิน 
combining-diacritical-marks-for-symbols : เครื่องหมายกำกับเสียงแบบรวมสำหรับสัญลักษณ์
letterlike-symbols : สัญลักษณ์ที่เหมือนตัวอักษร
number-forms    : รูปแบบตัวเลข
arrows          : ลูกศร 
mathematical-operators : ตัวดำเนินการทางคณิตศาสตร์
miscellaneous-technical : สัญลักษณ์ทางเทคนิคอื่นๆ
control-pictures : รูปภาพตัวควบคุม
optical-character-recognition : การรู้จำอักขระด้วยแสง
enclosed-alphanumerics : ตัวเลขพยัญชนะควบ
box-drawing     : เส้นวาดกล่อง
block-elements  : องค์ประกอบของบล็อก
geometric-shapes : รูปทรงเรขาคณิต
miscellaneous-symbols : สัญลักษณ์เบ็ดเตล็ด
dingbats        : Dingbats
miscellaneous-mathematical-symbols-a : สัญลักษณ์ทางคณิตศาสตร์เบ็ดเตล็ด-A 
suplemental-arrows-a : ลูกศรเสริม-A 
braille-patterns : รูปแบบอักษรเบรลล์
suplemental-arrows-b : ลูกศรเสริม-B
miscellaneous-mathematical-symbols-b : สัญลักษณ์ทางคณิตศาสตร์เบ็ดเตล็ด-B
supplemental-mathematical-operators : ตัวดำเนินการทางคณิตศาสตร์เสริม 
miscellaneous-symbols-and-arrows : สัญลักษณ์และลูกศรเบ็ดเตล็ด
glagolitic      : อักษรกลาโกลิติก
latin-extended-c : อักษรละตินส่วนเพิ่ม-C
coptic          : อักษรคอปติก 
georgian-supplement : อักษรจอร์เจียเพิ่มเติม 
tifinagh        : อักษรทิฟินาค 
ethiopic-extended : อักษรเอธิโอเปียส่วนเพิ่ม 
cyrillic-extended : อักษรซีริลลิกส่วนเพิ่ม-A
supplemental-punctuation : เครื่องหมายวรรคตอนเพิ่มเติม
cjk-radicals-supplement : รากศัพท์เพิ่มเติมของ CJK
kangxi-radicals : รากศัพท์แบบคังซี 
ideographic-description-characters : อักขระอธิบายเป็นอักษรภาพ
cjk-symbols-and-punctuation : สัญลักษณ์และเครื่องหมายวรรคตอนของ CJK 
hiragana        : อักษรฮิระงะนะ 
katakana        : อักษรคะตะกะนะ
bopomofo        : อักษรปอพอมอฟอ
hangul-compatibility-jamo : อักษรจาโมที่เข้ากันได้กับฮันกึล 
kanbun          : อักษรคัมบุน 
bopomofo-extended : อักษรปอพอมอฟอส่วนเพิ่ม
cjk-strokes     : เส้นขีดภาษาจีน ญี่ปุ่น เกาหลี
katakana-phonetic-extensions : ส่วนขยายทางสัทศาสตร์ของอักษรคะตะกะนะ
enclosed-cjk-letters-and-months : เดือนและอักษร CJK ที่แนบไว้ 
cjk-compatibility : ความเข้ากันได้กับ CJK 
cjk-unified-ideographs-extension-a : ส่วนขยาย A ของอักษรภาพรวมของ CJK
yijing-hexagram-symbols : สัญลักษณ์หกแถวของอี้จิง
cjk-unified-ideographs : อักษรภาพรวมของ CJK
yi-syllables    : พยางค์อี้
yi-radicals     : รากศัพท์อี้
old-lisu-alphabet : อักษรไว  
ciryllic-extended-B : อักษรซีริลลิกส่วนเพิ่ม-B
bamum           : อักษรบามุม
modifier-tone-letters : อักษรกำกับเสียง 
latin-extended-d : ละตินส่วนเพิ่ม-D
syloty-nagri    : อักษรสิเลฏินาครี 
indian-numeric-character : รูปแบบตัวเลขอินดิกที่พบบ่อย
phags-pa        : อักษรพักส์-ปา 
saurashtra      : อักษรเสาราษฏร์
devanagari-extended-characters : อักษรเทวนาครีส่วนเพิ่ม
kayah-li        : อักษรกะยา 
rejang          : อักษรเรชัง
hangul          : อักษรจาโมของฮันกึลส่วนเพิ่ม-A
javanese-alphabet : อักษรชวา  
cham-alphabet   : อักษรจาม
burmese-alphabet-extention-a : อักษรพม่าส่วนเพิ่ม-A
tai-viet-alphabet : ภาษาเวียดนาม 
meitei-language-extensions : อักษรมณีปุรีส่วนเพิ่ม
ethiopic-extended-a : อักษรเอธิโอเปียส่วนเพิ่ม-A
meitei-language : อักษรมณีปุรี
hangul-syllables : พยางค์ฮันกึล
high-surrogates : High Surrogates 
high-private-use-surrogates : High Private Use Surrogates
low-surrogates  : Low Surrogates
private-use-area : พื้นที่ใช้ส่วนตัว
cjk-compatibility-ideographs : อักษรภาพที่เข้ากันได้กับ CJK
alphabetic-presentation-forms : รูปแบบการนำเสนอเรียงตามอักษร
arabic-presentation-forms-a : รูปแบบการนำเสนอแบบอาหรับ-A
variation-selectors : ตัวเลือกชุดรูปแบบ
vertical-forms  : รูปแบบแนวตั้ง
combining-half-marks : เครื่องหมายรวมอักขระแบบครึ่ง
cjk-compatibility-forms : รูปแบบที่เข้ากันได้กับ CJK
small-form-variants : แวเรียนต์รูปแบบเล็ก 
arabic-presentation-forms-b : รูปแบบการนำเสนอแบบอาหรับ-B 
halfwidth-and-fullwidth-forms : รูปแบบครึ่งความกว้างและเต็มความกว้าง
specials        : พิเศษ
