arab: Арабский алфавит

armenian: Армянский алфавит

avestan: Авестийский алфавит

balinese: Балийский алфавит

bamum: Бамум алфавит

bashkir: Башкирский алфавит

bassa-vah: Басса алфавит

batak: Батакский алфавит

belarusian: Белорусский алфавит

bengali: Бенгальский алфавит

bopomofo: Чжуинь алфавит. Бопомофо

brahmi: Брахми алфавит

buginese: Бугийский алфавит

buhid: Бухид алфавит

bulgarian: Болгарский алфавит

carian: Карийский алфавит

caucasian-albanian: Кавказской Албании алфавит

chakma: Чакма алфавит

cham: Чамский алфавит

cherokee: Чероки слоговый алфавит

chinese: Китайский алфавит пиньинь

coptic: Коптский алфавит

cypriot-syllabary: Кипрский слоговый алфавит

cyrillic: Кириллица алфавит

czech: Чешский алфавит

deseret: Дезеретский алфавит

devanagari: Деванагари алфавит

elbasan: Эльбасанский алфавит

english: Английский алфавит

esperanto: Эсперанто алфавит

ethiopic: Эфиопский слоговый алфавит

french: Французский алфавит

georgian: Грузинский алфавит

german: Немецкий алфавит

glagolitic: Глаголица алфавит

gothic: Готский алфавит

grantha: Грантха алфавит

greek: Греческий алфавит

gujarati: Гуджарати алфавит

gurmukhi: Гурмукхи алфавит

hangul: Корейский алфавит хангыль

hanunoo: Хануноо алфавит

hebrew: Еврейский алфавит

hungarian: Венгерский алфавит

imperial-aramaic: Арамейский имперский алфавит

international-phonetic-alphabet: Международный фонетический алфавит

italian: Итальянский алфавит

japanese-hiragana: Японский алфавит хирагана

japanese-katakana: Японский алфавит катакана

javanese: Яванский алфавит

kaithi: Кайтхи алфавит

kannada: Каннада алфавит

kayah-li: Кайях ли алфавит

kazakh: Казахский алфавит

kharoshthi: Кхароштхи алфавит

khmer: Кхмерский алфавит

khojki: Кходжики алфавит

khudawadi: Кхудабади алфавит

lao: Лаосский алфавит

latin: Латинский алфавит

lepcha: Алфавит лепча

limbu: Алфавит лимбу

linear-b-Syllabary: Линейное письмо Б

lisu: Лису алфавит

lycian: Ликийский алфавит

lydian: Лидийский алфавит

mahajani: Махаджани алфавит

malayalam: Малаялам алфавит

mandaic: Мандейский алфавит

manichaean: Манихейский алфавит

meetei-mayek: Мейтей-маек алфавит

mende-kikakui: Кикакуи алфавит для менде

meroitic-cursive: Мероитский курсивный алфавит

modi: Моди алфавит

mongolian: Монгольский старый алфавит

mro: Мро алфавит

myanmar: Бирманский алфавит

nabataean: Набатейский алфавит

new-tai-lue: Тай лы новый алфавит

nko: Нко алфавит

ogham: Огамический алфавит

ol-chiki: Ол чики алфавит

old-italic: Этрусский алфавит

old-north-arabian: Аравийские северные старые алфавиты

old-permic: Пермский древний алфавит

old-persian: Персидский древний клинописный алфавит

old-south-arabian: Аравийский южный алфавит

old-turkic: Тюркский древний рунический алфавит

oriya: Ория алфавит

osmanya: Османья алфавит

pahawh-hmong: Пахау алфавит

pahlavi: Пехлеви алфавит

palmyrene: Пальмирский алфавит

pau-cin-hau: Пау Цин Хау алфавит

phags-pa: Пагба-ламы алфавит

phoenician: Финикийский алфавит

polish: Польский алфавит

pollard: Полларда алфавит

rejang: Реджанг алфавит

runic: Германский рунический алфавит

russian: Русский алфавит

samaritan: Самаритянский алфавит

saurashtra: Саураштра алфавит

sharada: Шарада алфавит

shavian: Бернарда Шоу алфавит

siddham: Сиддхаматрика алфавит

sinhala: Сингальский алфавит

sora-sompeng: Соранг сомпенг алфавит

spanish: Испанский алфавит

sundanese: Сунданский алфавит

syloti-nagri: Силхети нагари алфавит

syriac: Сирийский алфавит

tagalog: Тагальский алфавит

tagbanwa: Тагбанва алфавит

tai-le: Тай лы алфавит

tai-tham: Тай тхам алфавит

tai-viet: Тай вьет алфавит

takri: Такри алфавит

tamil: Тамильский алфавит

tatar: Татарский алфавит

telugu: Телугу алфавит

thaana: Тана алфавит

thai: Тайский алфавит

tibetan: Тибетский алфавит

tifinagh: Тифанаг алфавит

tirhuta: Тирхута алфавит

turkish: Турецкий алфавит

ugaritic: Угаритский алфавит

ukrainian: Украинский алфавит

unified-canadian-aboriginal-syllabics: Канадских аборигенов слоговый алфавит

vai: Ваи слоговый алфавит

varang-kshiti: Варанг кшити алфавит

yi-syllables: И язык слоговый алфавит
