title           : Таблица символов Юникода
search          : Поиск символа
find            : Найти
example         : Например
example_text    : серп и молот;треугольник;стрелка;сердце;звезда;пробел;телефон;круг;галочка;тире
about           : О проекте
not_language    : Нет моего языка
popular         : Чаще всего ищут
loading         : Подождите, идёт загрузка...
unicode_number  : Номер в Юникоде
html_code       : <span class="caps">HTML</span>-код
uppercase       : Прописная
lowercase       : Строчная
encoding        : Кодировка
block           : Раздел
set             : Набор
up              : Наверх
range           : Диапазон
type            : Тип
countries       : Страны
count           : Количество символов
languages       : Языки
sort_order      : По порядку
sort_block      : По разделам
copy_clipboard  : Скопировать в буфер
search_h1       : Поиск символа
search_result   : Результаты поиска по фразе
search_empty    : Поисковая фраза не введена
search_total    : Всего найдено: %s
search_limit    : (показано только %s)
search_none     : Ничего не нашлось
search_any      : По фразе ничего не нашлось. Используем поиск по всем словам.
help_range      : Нажмите, чтобы подсветить
blocks_list     : Разделы Юникода
languages_list  : Языки
languages_blocks : Язык представлен в следующих разделах
more            : Подробнее
sets            : Наборы символов
ny_symbols      : Новогодние символы
prev            : Пред.
next            : След.
entity          : Мнемоника
search_overflow : Извините, символ U+%s разрабатывается :)
separate_page   : Открыть на отдельной странице
edit            : Изменить
save            : Сохранить
submit          : Отправить
undo            : Отменить
send_changes    : Изменение будет отправлено на рассмотрение разработчикам сайта. Вы уверены?
edit_thanks     : Спасибо!
gotofullversion : Перейти к полной версии
sharelink       : Поделиться с друзьями
recent          : Последние использованные
recentText      : Здесь будут показываться последние использованные вами символы, а пока вот популярные
toMobile        : Перейти на мобильную версию
readmore        : Подробнее
readless        : Скрыть
yourbrowser     : Ваш браузер
fontview        : Начертание этого символа в разных шрифтах
chardesc        : Описание символа

# __________________________________________________________
#
# FOOTER / МЕНЮ ПОДВАЛА
# __________________________________________________________

feedback        : Отзывы и предложения
github          : ГитХаб
twitter         : Твиттер
join_us         : Хочу участвовать в проекте
donate          : Как поддержать проект
unicode         : Юникод
about_unicode   : Что такое Юникод
unicode_history : История создания Юникода
unicode_versions: Версии Юникода
broken_chars    : Почему не отображаются некоторые символы
cyrillic        : Кириллица
fonts           : Шрифты



# __________________________________________________________
#
# TOOLS / ИНСТРУМЕНТЫ    http://unicode-table.com/tools/
# __________________________________________________________

tools           : Инструменты
encoder         : HTML-кодировщик
encoder-desc    : Кодирует символы в html-код и обратно
encoder-plain   : Простой текст
encoder-full    : Всё
encoder-entities: Кодировать символы, имеющиие мнемоники мнемониками
encoder-br      : Учитывать переносы строк

decoder         : Юникод ⇆ Текст
decoder-desc    : Закодирует символы в Юникод или раскодирует обратно
decoder-example : Это пример
decoder-code    : Юникод
decoder-text    : Текст

flip            : Переворачивалка символов
flip-desc       : Переворачивает кириллические и латинские символы вверх ногами или задом наперёд
flip-plain      : Простой текст
flip-flipped    : Перевёрнутый вверх ногами
flip-backed     : Задом наперёд

toolsgenerator : Генератор таблицы символов Юникода
toolsgenerator-desc : Сформирует набор символов в указанном диапазоне
toolsgenerator-range: Диапазон
toolsgenerator-format: Формат
toolsgenerator-info: Доступно: {symbol}, {dec}, {hex}, {html}
toolsgenerator-text-generate: Генерировать
toolsgenerator-result: Результат

# CONTENT

content-sorry: Извините, пока нет подробной информации.
content-sorry-lang: Извините, эта страница пока не переведена на русский. Мы работаем над переводом не покладая рук.
content-other: Этот текст также доступен на следующих языках:
content-sorry-other: Но вы можете почитать его на следующих языках:

# SEO

meta_description : Все символы Юникода на одной странице c названиями и описаниями: ❤ ☀ ★ ☂ ☻ ♞ ☯ ☭ ☢ € → ☎ ❄ ♫ ✂ ▶ ✇ ♎ ⇧ ☮ ♻ ⌘ ⌛ ☘ ✈ ✔ ☊ ♔ ♕ ♖ ☦ ✝ ❖ ➎ ♠ ♣ ♥ ♦ ♂ ♀ ❂ ❃ ✒
meta_keywords   : юникод, символы, таблица символов, utf-8, символы вконтакте, кодировка, письменность, языки, эмоджи, эмодзи, иероглифы, руны, стрелочки, сердечки, кириллица, символы валют
symbol_description: Символ: {{symbol}}, Название: {{name}}, Номер в юникоде: {{code}}, Раздел: {{block}}{% if entity %}, Мнемоника: {{ entity }}{% endif %}
symbol_title: символ, знак, значок, иконка
